{
  "width": 32,
  "height": 32,
  "tiles": [
    ["w","w","w","w","w","w","w","w","w","w","w","w","w","w","w","w","w","w","w","w","w","w","w","w","w","w","w","w","w","w","w","w"],
    ["w","g","g","g","g","g","g","g","g","g","g","g","g","g","g","g","g","g","g","g","g","g","g","g","g","g","g","g","g","g","g","w"],
    ["w","g","g","g","g","g","g","g","g","g","g","g","g","g","g","g","g","g","g","g","g","g","g","g","g","g","g","g","g","g","g","w"],
    ["w","g","g","g","g","g","g","g","g","g","g","g","g","g","g","g","g","g","g","g","g","g","g","g","g","g","g","g","g","g","g","w"],
    ["w","g","g","g","g","g","g","g","g","g","g","g","g","g","g","g","g","g","g","g","g","g","g","g","g","g","g","g","g","g","g","w"],
    ["w","g","g","s","g","g","g","g","g","g","g","g","g","g","g","g","t","g","g","g","g","g","g","g","g","g","g","g","g","g","g","w"],
    ["w","g","g","g","g","g","g","g","g","g","g","g","g","g","g","g","g","g","g","g","g","g","g","g","g","g","g","g","g","g","g","w"],
    ["w","g","g","g","g","g","g","g","g","g","g","g","g","g","g","g","g","g","g","g","g","g","g","g","g","g","g","g","g","g","g","w"],
    ["w","g","g","g","g","g","g","g","g","g","g","g","g","g","g","g","g","g","g","g","g","g","g","g","g","g","g","g","g","g","g","w"],
    ["w","g","g","g","g","g","g","g","g","g","g","g","g","g","g","g","g","g","g","g","g","g","g","g","g","g","g","g","g","g","g","w"],
    ["w","g","g","g","g","g","g","g","g","g","g","g","g","g","g","g","g","g","g","g","g","g","g","g","g","g","g","g","g","g","g","w"],
    ["w","g","g","g","g","g","g","g","g","g","g","g","l","l","g","g","g","g","g","g","g","g","g","g","g","g","g","g","g","g","g","w"],
    ["w","g","g","g","g","g","g","g","g","g","g","g","l","l","g","g","g","g","g","g","g","g","g","g","g","g","g","g","g","g","g","w"],
    ["w","g","g","g","g","g","g","g","g","g","g","g","g","g","g","g","g","g","g","g","g","g","g","g","g","g","g","g","g","g","g","w"],
    ["w","g","g","g","g","g","g","g","g","g","g","g","g","g","g","g","g","g","g","g","g","g","g","g","g","g","g","g","g","g","g","w"],
    ["w","g","g","g","g","g","g","g","g","g","g","g","g","g","g","g","g","o","g","g","g","g","g","g","g","g","g","g","g","g","g","w"],
    ["w","g","g","g","g","g","g","g","g","g","g","g","g","g","g","g","g","g","g","g","g","g","g","g","g","g","g","g","g","g","g","w"],
    ["w","g","g","g","g","g","g","g","g","g","g","g","g","g","g","g","g","g","g","g","g","g","g","g","g","g","g","g","g","g","g","w"],
    ["w","g","g","g","g","g","g","g","g","g","g","g","g","g","g","g","g","g","g","g","g","g","g","g","g","g","g","g","g","g","g","w"],
    ["w","g","g","g","g","g","g","g","g","g","g","g","g","g","g","g","g","g","g","g","g","g","g","g","g","g","g","g","g","g","g","w"],
    ["w","g","g","g","g","g","g","g","g","g","g","g","g","g","g","g","g","g","g","g","g","g","g","g","g","g","g","g","g","g","g","w"],
    ["w","g","g","g","g","g","g","g","g","g","g","g","g","g","g","g","g","g","g","g","g","g","g","g","g","g","g","g","g","g","g","w"],
    ["w","g","g","g","g","g","g","g","g","g","g","g","g","g","g","g","g","g","g","g","g","g","g","g","g","g","g","g","g","g","g","w"],
    ["w","g","g","g","g","g","g","g","g","g","g","g","g","g","g","g","g","g","g","g","g","g","g","g","g","g","g","g","g","g","g","w"],
    ["w","g","g","g","g","g","g","g","g","g","g","g","g","g","g","g","g","g","g","g","g","g","g","g","g","g","g","g","g","g","g","w"],
    ["w","g","g","g","g","g","g","g","g","g","g","g","g","g","g","g","g","g","g","g","g","g","g","g","g","g","g","g","g","g","g","w"],
    ["w","g","g","g","g","g","g","g","g","g","g","g","g","g","g","g","g","g","g","g","g","g","g","g","g","g","g","g","g","g","g","w"],
    ["w","g","g","g","g","g","g","g","g","g","g","g","g","g","g","g","g","g","g","g","g","g","g","g","g","g","g","g","g","g","g","w"],
    ["w","g","g","g","g","g","g","g","g","g","g","g","b","b","g","g","g","g","g","g","g","g","g","g","g","g","g","g","g","g","g","w"],
    ["w","g","g","g","g","g","g","g","g","g","g","g","g","g","g","g","g","g","g","g","g","g","g","g","g","g","g","g","g","g","g","w"],
    ["w","g","g","g","g","g","g","g","g","g","g","g","g","g","g","g","g","g","g","g","g","g","g","g","g","g","g","g","g","g","g","w"],
    ["w","w","w","w","w","w","w","w","w","w","w","w","w","w","w","w","w","w","w","w","w","w","w","w","w","w","w","w","w","w","w","w"]
  ]
}
